................
...........R....
..P......_____..
................
.............M..
.P..RD.F........
...._____.......
................
..........M.....
................
F.H..FT.V.B..F.S
________________