H...............
__............P.
........F.......
.......___......
.M..........P...
F...............
__.............F
............____
..............P.
...M............
F.......B......D
________________