..M.............
...............H
..F....M.....___
..__............
......M....F....
..M.......__....
..M.........M...
..DB....M.......
..__........F...
...........___..
F..M.....M.....M
________________