................
..........F.....
.....P....____..
.....F.......H..
.M..._..........
................
...F............
...__...........
..............P.
...P............
B.....D....F....
________________