...............F
..............__
..H.............
..__............
......P....F....
..........__....
................
..F.....P.......
..__........B...
...........___..
F..P.....P...D.P
________________