................
F...........F...
__...P..._____..
................
.M..............
....F.H.........
...._____.......
................
.............M..
...P............
D.........B___F.
________________